10123
1111111111
2111211111
1111111111
1111111111
1111111111
1111111111
2111122111
1111211111
1111111112
1111111111
