5_OH
O___O______O________
_________OO_____O__O
___OO____O________O_
_______O___O___O____
O__O_O______O_OOO__O
